815  815  815  815  815  815  815  815  815  815  815  815  815  815  815  815  815  815  815  815  815  815  815  815  815  815  815  815  815  815  815  
815  815  815  815  815  815  815  815  815  815  815  815  815  815  815  815  815  815  815  815  815  815  815  815  815  815  815  815  815  815  815  
815  815  815  815  815  815  815  815  815  815  815  815  815  815  815  815  815  815  815  815  815  815  815  815  815  815  815  815  815  815  815  
815  815  815  815  815  815  815  815  815  815  815  815  815  815  815  815  815  815  815  815  815  815  815  815  815  815  815  814  815  815  815  
815  814  814  814  814  814  814  814  814  815  815  815  815  817  817  126  815  815  815  815  815  815  815  815  815  815  815  814  815  815  815  
815  815  815  814  814  814  814  814  814  815  815  815  152  153  154  155  815  815  815  815  815  815  815  815  815  165  166  814  815  815  815  
815  814  172  173  815  815  815  815  815  179  815  815  182  183  183  184  815  815  187  188  189  21  190  191  192  193  194  814  815  815  815  
815  814  201  202  815  815  815  815  207  208  21  209  210  183  183  211  212  213  214  214  214  214  214  214  214  215  21  814  815  815  815  
815  814  814  220  221  222  815  815  225  226  189  188  227  228  229  230  231  232  232  232  232  232  232  232  232  233  21  814  815  815  815  
815  815  240  21  241  242  243  814  814  194  188  189  188  246  247  247  247  247  247  247  247  247  247  248  232  233  249  814  815  815  815  
815  815  816  816  816  816  816  815  815  815  816  816  816  816  816  816  816  816  816  816  816  816  816  246  247  262  814  814  815  815  815  
815  814  266  214  214  215  814  814  815  815  813  813  813  813  813  813  813  815  813  813  813  813  813  813  813  813  813  814  815  815  815  
815  814  814  232  232  233  279  815  815  815  814  813  283  813  813  813  813  813  813  813  813  21  813  813  813  813  813  814  815  815  815  
815  815  290  291  292  262  190  815  815  815  815  813  814  813  813  813  813  813  813  283  813  813  813  813  813  813  21  301  815  815  815  
815  815  815  308  309  815  815  815  815  815  815  815  815  815  815  815  815  815  815  815  815  815  815  815  308  309  815  815  815  815  815  
815  815  814  320  321  215  188  21  815  815  815  815  815  815  815  815  329  194  21  21  166  21  21  188  330  215  814  815  815  815  815  
815  815  814  814  247  262  21  21  815  815  815  815  815  815  815  815  815  330  214  214  214  214  214  214  345  346  814  815  815  815  815  
815  815  815  355  21  21  21  21  815  815  815  815  815  815  815  815  815  246  247  247  247  247  247  247  247  814  814  815  815  815  815  
815  815  815  816  816  816  816  816  816  815  815  815  815  815  815  816  816  816  816  816  816  816  813  813  813  376  815  815  815  815  815  
815  815  814  814  21  188  187  21  383  191  814  814  386  387  388  389  194  21  21  21  188  813  813  813  813  813  814  815  815  815  815  
815  815  814  396  194  189  188  194  21  397  814  814  400  188  401  814  403  21  814  814  814  813  813  283  813  813  814  815  815  815  815  
815  815  814  414  187  188  187  189  21  415  815  815  815  814  814  814  814  814  815  814  814  813  813  813  283  813  814  815  815  815  815  
815  815  814  431  383  21  194  188  21  432  815  815  815  815  815  815  815  815  815  815  815  813  813  813  813  813  814  815  815  815  815  
815  815  815  816  816  816  816  816  816  816  815  815  815  814  814  814  815  815  815  815  815  813  813  813  813  813  814  455  815  815  815  
815  814  460  330  214  214  214  215  194  188  194  461  814  814  814  814  814  464  190  191  192  465  188  813  813  813  815  815  815  815  815  
815  814  465  471  232  232  232  321  214  214  214  472  814  814  814  814  814  473  214  214  214  214  214  214  215  194  814  815  815  815  815  
815  814  814  471  232  478  247  247  247  814  814  481  814  814  814  814  814  483  814  814  247  247  248  232  233  188  484  815  815  815  815  
815  815  815  491  492  493  815  815  815  815  815  815  815  815  815  815  815  815  815  815  815  815  502  492  493  815  815  815  815  815  815  
815  815  814  814  232  321  214  214  215  815  815  507  508  815  815  815  815  208  815  815  161  512  471  232  233  161  815  815  815  815  815  
815  815  518  519  232  232  232  232  233  188  187  520  521  522  223  523  524  226  21  21  189  188  471  232  233  194  815  815  815  815  815  
815  815  814  814  531  814  814  814  535  194  189  194  536  537  243  538  539  814  814  21  194  330  345  232  321  214  215  542  815  815  815  
815  815  815  815  814  814  814  815  814  814  551  814  553  814  555  187  556  814  814  557  21  471  232  558  232  232  233  415  815  815  815  
815  815  815  815  815  815  815  815  815  815  815  815  815  815  815  815  815  815  815  572  21  246  247  247  248  232  233  573  815  815  815  
815  815  815  815  815  815  815  815  815  815  815  815  815  815  815  815  815  815  815  396  813  813  21  188  471  232  233  21  815  815  815  
815  815  815  815  815  815  815  815  815  815  815  815  815  815  815  815  815  815  815  813  813  813  813  813  246  247  262  600  815  815  815  
815  815  815  815  815  815  815  815  815  815  815  815  815  815  815  815  815  815  815  813  813  283  813  813  813  816  816  815  815  815  815  
815  815  815  815  815  815  815  815  815  815  815  815  815  815  815  815  815  813  813  813  813  813  813  813  813  330  215  814  815  815  815  
815  815  815  815  815  815  815  815  815  815  815  815  815  637  638  639  813  813  813  813  813  813  813  813  813  471  233  484  815  815  815  
815  815  814  266  643  644  645  646  214  214  214  214  214  214  214  214  214  214  214  214  214  214  214  214  214  345  233  814  815  815  815  
815  815  814  814  478  247  247  247  247  247  247  813  247  247  247  247  247  247  247  247  247  247  247  247  247  247  262  815  815  815  815  
815  815  815  290  262  816  816  816  816  816  816  815  816  816  816  816  816  816  816  816  816  816  816  816  816  816  816  815  815  815  815  
815  815  815  813  813  813  813  813  813  813  330  214  214  214  813  813  813  214  214  214  215  813  600  813  813  813  813  815  815  815  815  
815  815  814  813  813  813  813  813  670  813  471  232  232  813  813  813  813  232  232  478  262  813  813  813  813  670  813  815  815  815  815  
815  815  814  813  813  600  813  813  813  813  246  813  813  813  813  677  813  232  478  262  813  813  813  813  813  813  813  815  815  815  815  
815  815  814  813  813  813  600  813  187  188  813  813  814  813  813  813  813  814  814  813  813  813  813  813  813  813  813  814  815  815  815  
815  815  814  814  813  813  813  189  188  189  813  814  813  813  813  232  233  699  814  813  813  813  815  813  813  813  813  814  815  815  815  
815  815  815  813  813  670  813  194  189  813  813  815  21  471  232  232  233  187  815  813  815  712  813  600  813  813  813  815  815  815  815  
815  815  815  814  813  813  813  814  721  722  814  814  725  246  247  247  262  726  814  814  815  815  813  814  813  813  813  815  815  815  815  
815  815  815  815  815  815  815  815  815  745  813  815  815  813  813  813  813  749  814  815  815  815  815  815  814  814  814  815  815  815  815  
815  815  815  815  815  815  815  815  815  815  815  815  815  813  813  813  813  814  814  815  815  815  815  815  815  815  815  815  815  815  815  
815  815  815  815  815  815  815  815  815  815  815  815  797  813  813  813  813  800  815  815  815  815  815  815  815  815  815  815  815  815  815  

